4
10 3
##########
#..****..@
##########
1 1
10 5
##########
#..####*.#
#..***#**#
#..##....@
##########
2 1
10 6
##########
#..#...#.#
#..#.#.**#
#..#...*##
#*****...@
##########
2 1
10 10
##########
#..##....#
#..#..##.#
#..#.....#
#********#
.**#****.@
#*.******#
##*****..#
#.*****..#
##########
0 5