2
5 5
#####
#...#
#...@
#..##
#####
1 1
7 5
#######
#...#.@
###.#.#
  #...#
  #####
1 1