3
8 3
########
#..a..A@
########
1 1
8 8
####    
#..#    
#.a#    
##A#####
#...b..#
#......#
#..#..B@
########
1 2
10 10 
##########
#.......a#
#........#
###....###
#.....ABC@
#b.....###
#.###....#
#.###....#
#.......c#
##########
1 4