2
5 5
#####
#...#
#...@
#..##
#####
1 1
8 8
########
#......#
##..#..#
#......#
#.##...#
#......@
#......#
########
1 1
10 10
##########
#..#..#..#
#..#..#..#
#........#
####..##.#
#........#
#........#
#........#
#........@
##########
1 1