2
10 3
##########
#..**a**A@
##########
1 1
10 6
##########
#..#.a.#.#
#..#.#.**#
#..#...*A#
#******..@
##########
2 1