2
5 5
#####
#...#
#...@
#..##
#####
1 1
7 5
#######
#.a.#.@
###A#B#
  #.b.#
  #####
1 1