1
This final level is a mix of all the previous levels.
3
10 3
##########
#..**a**A@
##########
1 1
10 6
##########
#..#.a.#.#
#..#.#.**#
#..#...*A#
#******..@
##########
2 1
20 10
####################
#...********....C.b#
#...********....#..#
#***...*****....#A##
#***.c.*****.......#
#***...**a**.......#
#***...*****...e#..#
#**#####........#..#
#**..d.B........D.E@
####################
1 1